[1104 2972    0    2    0    0    0    0]
[2938  766    2    0    0    0   -2    0]
[ 288 1552    2   -2    0    0   -2    0]
[4100 2774    2   -2    0    0    0   -2]
[1310 1764    0    2    0    0    0    0]
[1712 2772    0    0    0    0   -2    0]
[3734 1180    0    0    0    0    0    0]
[ 698 2166    0    2    0    0    2    0]
[2336  350   -2    2    0    0   -2    2]
[1106 1762    0    0    0    0    0    0]
[3516 2378    0    0    0    0   -2    0]
[ 494 2366    4    0    0    0    0    0]
[3546  368    0    0    0    0   -2    0]
[2916 2774    2    0    0    0    0    0]
[4308 2184    2    0    0    0   -2    2]
[1104 3172    2    0    0    0   -2    0]
[2718 2574    2    0    0    0    0    0]
[3908 2578    0    0    0    0   -2    0]
[ 700 3168    2    0    0    0    0    0]
[2712 2972    0    0    0    0   -2   -2]
[1910 3370    0    2    0    0    0   -2]
[2712 3170    0    0    0    0   -2   -2]
[2732 1372    2    2    0    0    0    2]
[1724  750    2    0    0    0    0    0]
[3140  768    2    0    0    0   -2    0]
[1106 1558    0   -2    0    0   -2   -2]
[3138  970    2    0    0    0    0    0]
[3500 3366    0    0    0    0    0    0]
[2530 1368    4   -2    0    0    0    0]
[3114 2774    2    0    0    0    0    0]
[2934 1170    2    0    0    0   -2    0]
[698 532   0   2   0   0  -2   0]
[ 292 2766    0   -2    0    0    0   -2]
[1106 2166    2    0    0    0   -2   -6]
[906 328   2   0   0   0   0   0]
[ 902 1964    2    0    0    0    0    2]
[1512 2168    2    0    0    0    0   -2]
[ 492 1960    2    0    0    0    0    0]
[2708 3368    0   -2    0    0   -2   -2]
[3304 3366    2    0    0    0    0    0]
[3744  574    0    0    0    0    0    0]
[4282 3362    0    2    0    0   -2   -4]
[2736  764    0    0    0    0    0    2]
[3724 1782    0   -2    0    0   -2    0]
[3922 1784    0    2    0    0   -2    0]
[1924 1160    2    0    0    0    0    0]
[2120 2172    2    0    0    0    0   -2]
[ 494 1552    2   -2    0    0    4    0]
[1318  128    2    0    0    0    0    0]
[3738  978    0    0    0    0    0    0]
[3934 1182    2    0    0    0    2   -2]
[3534 1178    0    0    0    0   -2    0]
[2312 3370    2    2    0    0    0    0]
[3746  372    0    0    0    0    0    0]
[3312 2776    0    2    0    0   -2    0]
[3544  570    0    0    0    0    0    0]
[ 696 1146    0    0    0    0   -2   -2]
[3942  578    0    0    0    0    0    0]
[ 494 2568    2    0    0    0    0    0]
[2332  758    0    0    0    0    0    2]
[2512 2972   -2    0    0    0   -4    0]
[3142  566    0    0    0    0   -2    2]
[4510 1788    2    0    0    0   -2    0]
[1712 2972    2    0    0    0    0    0]
[4094 2972    0    2    0    0    0    0]
[2320 2172    0    2    0    0   -2   -2]
[ 288 1756    0    2    0    0    0    0]
[ 700 2970    4    0    0    0    0    2]
[4126 1384    0    0    0    0   -2   -2]
[2912 2972    0    0    0    0    0   -2]
[2928 1776    2    0    0    0    2    0]
[2528 1572    2    2    0    0    0    2]
[1110  332    2    0    0    0    0    2]
[1510 2772    0    2    0    0   -2    0]
[3336 1176    2    0    0    0    2    2]
[3112 2972    2   -2    0    0    0   -2]
[1918 2170    2    0    0    0    0   -2]
[2526 1772    2    0    0    0    0    0]
[1308 2570   -2    0    0    0    0    0]
[1708 3370    0    0    0    0   -4    0]
[2518 2574    0    0    0    0    0    0]
[1922 1362    0    0    0    0    0    0]
[1108  946    2    0    0    0    0    0]
[ 288 2162    0   -2    0    0   -2    0]
[ 290 2366    0    2    0    0   -2    0]
[1928  548    0    2    0    0    0    0]
[3740  778    2    2    0    0   -2    2]
[3550  166    2   -2    0    0    2    0]
[ 80 318   0   0   0   0  -2   0]
[492 734   0   0   0   0  -2  -2]
[2736  966    0    0    0    0    2    0]
[2524 1972    2   -2    0    0    0   -2]
[904 534   2   0   0   0  -2   0]
[902 740   0   2   0   0   0   2]
[ 900 2166    0    0    0    0    0    0]
[2312 3172    0    2    0    0   -2    2]
[3146  362    2    0    0    0   -2    0]
[4090 3168    0    0    0    0   -2    0]
[4088 3362    2    0    0    0    0    0]
[2326 1570    0    0    0    0   -4    0]
[1514 1966    0    0    0    0    0   -2]
[ 294 3368    0    0    0    0    0    0]
[3708 2774    0   -2    0    0   -2   -2]
[1910 3172   -2    0    0    0   -2    0]
[3540  774   -2    0    0    0    0    0]
[906 122   2  -2   0   0   0  -2]
[2538  558    2    2    0    0   -2    2]
[3538  976    2    0    0    0   -2    0]
[2316 2774    2    0    0    0   -2    0]
[4534  588    0    0    0    0    0    0]
[2320 2372    2   -2    0    0    0   -2]
[494 530   2   0   0   0   0   0]
[1110  126    0    0    0    0   -2   -2]
[ 288 1348    2    2    0    0    0    0]
[1510 2972    2    0    0    0    0    0]
[ 492 1348    2   -2    0    0    0   -2]
[1108 1152    0    2    0    0    0    0]
[  88 2566    0    2    0    0    0    2]
[3514 2578    0    0    0    0   -2    0]
[3916 2182    0    0    0    0    0   -4]
[4108 2380    2   -2    0    0    0    0]
[2716 2774    2    2    0    0    0    0]
[3134 1174    0    0    0    0   -2    2]
[3106 3368    0    0    0    0   -2    0]
[4294 2774    0    0    0    0    0    0]
[1306 2972    2    0    0    0   -2    0]
[1714 2572    2    0    0    0    2    0]
[2134  346    2    0    0    0    0    0]
[4140  582    2    2    0    0    0    0]
[2520 2374    0    0    0    0    0    0]
[  84 1346    2    0    0    0   -2    0]
[3316 2576    2    0    0    0    0    0]
[4300 2578    2    0    0    0    2   -2]
[4488 2776   -2    2    0    0   -2    2]
[1914 2972    2    0    0    0    0    0]
[2910 3172    0    0    0    0    0    0]
[3526 1780    2    0    0    0    0    0]
[2314 2972    2    0    0    0    0    0]
[4476 3360    0   -4    0    0   -4   -4]
[  88 2766    0    0    0    0   -2    0]
[3306 3170    0    0    0    0   -2   -2]
[ 494 2162    2   -2    0    0    2   -2]
[288 528   2   2   0   0  -2   0]
[1510 2570   -2   -2    0    0   -2   -2]
[3912 2380    0    0    0    0   -2   -2]
[4342  184   -2    2    0    0   -2    2]
[ 290 2566    0   -2    0    0   -2    0]
[1916 2372    0    0    0    0   -2    0]
[ 698 1556    2    0    0    0    2    0]
[1930  138    2    2    0    0   -2    0]
[  92 3368    2    0    0    0    0    0]
[3716 2380    2    0    0    0    0    0]
[3920 1982    2    0    0    0    0   -2]
[3948  174    2   -2    0    0    2   -2]
[3528 1580    2    0    0    0   -2    0]
[4144  180   -2    2    0    0    0    0]
[1106 2370    2    2    0    0    0    0]
[4116 1984    0    0    0    0    0    0]
[2942  562    0    0    0    0   -2    0]
[1716 2372    2    2    0    0    2    0]
[3700 3168    0   -2    0    0   -2   -2]
[1914 2572    2    0    0    0    0    0]
[2724 1974    0    0    0    0    0   -2]
[2540  352    2    0    0    0   -2    0]
[3348  162    2    0    0    0   -2    0]
[1518  540    0    0    0    0   -2   -2]
[1724  340    0    0    0    0   -2    0]
[2532 1166    2    0    0    0    0    0]
[2122 1970    2    0    0    0    0    0]
[ 80 528   2   4   0   0  -2   2]
[ 496 2768    2   -2    0    0    0    0]
[1108 1356    2    0    0    0    0    2]
[ 696 1758    2    0    0    0    0    0]
[3332 1376    0   -2    0    0    2    0]
[3944  376    0   -2    0    0   -2    0]
[4314 1786    0    0    0    0   -2    0]
[492 940   2   2   0   0   0   2]
[1104 2770    2   -2    0    0    0   -2]
[1518  748    0    0    0    0    0    2]
[3510 2776    0    2    0    0   -2    0]
[4528  790   -2    0    0    0    0    0]
[3718 2180    0    0    0    0    0   -2]
[3930 1382    2    0    0    0    0    0]
[ 498 3368    2    0    0    0   -2    0]
[3730 1380    0    0    0    0   -4    0]
[3904 2774    0   -2    0    0   -4   -2]
[2924 1976    2    0    0    0   -2    0]
[2936  968    0   -2    0    0   -2    0]
[4338  384    2    0    0    0    0    0]
[3346  364    0    0    0    0   -2    0]
[4136  782    2   -2    0    0   -2   -2]
[2330 1164    2    0    0    0    0    0]
[1926  752    0    0    0    0   -2   -2]
[ 82 112   4   0   0   0   2   0]
[3728 1580    2   -2    0    0   -2   -2]
[1508 3370    2    0    0    0    0   -2]
[1310 2368    2    0    0    0    0   -2]
[3896 3168    0    0    0    0    0    0]
[4134  984    2    2    0    0    0    0]
[ 82 936   2   0   0   0  -2   0]
[286 938   0   0   0   0  -4   2]
[4522 1190    0    0    0    0    0    0]
[ 498 2968    2   -2    0    0    0   -2]
[1722 1360    4   -2    0    0    2    0]
[1716 1968    0    0    0    0   -2    0]
[3122 2176    2    0    0    0    0    0]
[3320 2178    0   -2    0    0   -2    0]
[2732 1168    2    0    0    0   -2    0]
[2328 1366    2    0    0    0    0   -2]
[1728  134    2    0    0    0    0    2]
[3318 2378    2    2    0    0    0    0]
[1310 1966    2    0    0    0   -2    0]
[1306 3170    0   -2    0    0   -2   -2]
[3720 1982    2    2    0    0   -4    0]
[1920 1768    0    0    0    0    0    0]
[2122 1768    0   -2    0    0    0    0]
[286 114   0   0   0   0   0   0]
[3520 2178    2    0    0    0    0   -2]
[ 900 1556    0    0    0    0   -2    0]
[1512 2370    0    0    0    0    0    0]
[3342  568    0    0    0    0   -2    0]
[3132 1376    0    0    0    0    0    0]
[4330  988    0    2    0    0    2    0]
[1308 2772    2    0    0    0    0    0]
[4130 1184    0    0    0    0   -2    0]
[1312  538    0    0    0    0   -2    0]
[3936  982   -2    2    0    0   -2    2]
[3926 1584   -2    0    0    0   -2    0]
[3330 1578    2    0    0    0    0    0]
[2116 2772    2    0    0    0    2    0]
[1310 1562    0    0    0    0   -2    2]
[1316  332    2   -2    0    0    0   -2]
[3712 2576    2   -2    0    0    0   -2]
[2944  358    2    0    0    0   -2    0]
[  86 2362    2    0    0    0   -2    0]
[4324 1386    2   -2    0    0    0   -2]
[4312 1984    2   -2    0    0    0   -2]
[4538  386    4   -4    0    0   -2    0]
[2124 1566    0    0    0    0    0   -2]
[494 118   0  -2   0   0  -2  -2]
[ 902 1354    2    2    0    0    0    0]
[ 288 1958    2    0    0    0    0   -2]
[1108  742    2    0    0    0    0    2]
[1522  338    2    0    0    0    0    2]
[1522  130    2    0    0    0    0    0]
[2534  760   -2    0    0    0   -2    0]
[1922 1564    2   -2    0    0    0   -2]
[4486 2972    2    0    0    0    0   -2]
[1516 1360    2    2    0    0    0    0]
[1308 2168    0    0    0    0   -2    0]
[4304 2382    0    2    0    0    2    0]
[696 942   0  -2   0   0  -2   0]
[ 904 3368    2    0    0    0    0    0]
[3902 2972    4    0    0    0    2    0]
[3748  170    0    0    0    0   -2    0]
[ 696 2368   -2    0    0    0    0    0]
[4542  184    0   -2    0    0    0   -2]
[ 288 1144    2    0    0    0    0    2]
[3530 1378    0    0    0    0   -2   -2]
[1716 2170    2    0    0    0    0    0]
[2136  140    4    0    0    0    0    0]
[3890 3364   -2    2    0    0   -2    0]
[2324 1770    0   -2    0    0    0    0]
[1720 1160    0    0    0    0   -2    4]
[1312  950    0    0    0    0   -2    0]
[1108  536    0    0    0    0   -2   -2]
[2744  150    2    0    0    0   -2    0]
[2130  550    0    0    0    0   -2    0]
[  86 2162    0    2    0    0    0    2]
[1518 1156    4    0    0    0    2    0]
[4284 3168   -2    2    0    0    0    2]
[1106 1964    0   -2    0    0    0    0]
[1712 3172    2    0    0    0    2    0]
[2542  148    2    0    0    0   -2    2]
[3128 1778    2    2    0    0    0    2]
[3508 2972    0   -2    0    0    0   -2]
[2932 1374    2    0    0    0    0    2]
[1312 1154    0    2    0    0   -2    0]
[4518 1390    0    0    0    0   -2    0]
[3338  974    2    0    0    0    0    2]
[1914 2772    0    0    0    0    0    0]
[4332  786    0    0    0    0    0    0]
[4120 1786    0    2    0    0    0    0]
[1306 3370    0    0    0    0   -2    0]
[4482 3168    0    0    0    0    0    2]
[4506 1986    0    0    0    0   -2    0]
[1718 1766    2    0    0    0    0    0]
[1314  746    2    0    0    0    2    2]
[1928  344    0    0    0    0    0    2]
[1722  954    2   -2    0    0    0   -2]
[2720 2376    0    0    0    0   -2    0]
[2110 3370    2    0    0    0    0    2]
[ 292 2968    0    0    0    0   -2    0]
[1312 1356    0    0    0    0    2    0]
[ 902 2366    2   -2    0    0    0   -2]
[ 698 2772    0    2    0    0    0    2]
[ 900 2972    0    0    0    0   -2    2]
[2126 1162    0    0    0    0   -2    2]
[2116 2572    2    0    0    0   -2   -2]
[3118 2576    4    0    0    0    2    0]
[288 322   0   0   0   0   0   0]
[ 902 3170    0    0    0    0    0    0]
[2128  960    0    0    0    0   -2    0]
[4140  380   -2   -2    0    0   -2   -2]
[3940  780    2    0    0    0    0    0]
[2742  356    2    0    0    0    0    2]
[1718 1564    0    0    0    0    0    0]
[2930 1576    0    2    0    0    0    2]
[3326 1780    2    2    0    0   -2    2]
[1510 3172    2    2    0    0    0    0]
[2522 2174    2    0    0    0    0    0]
[286 734   0   2   0   0  -4   2]
[4526  990    2    0    0    0    0    0]
[ 698 2568    0   -2    0    0    0   -2]
[698 738   2   0   0   0   2   2]
[1926  958    0    4    0    0    0    2]
[2130  756    0    0    0    0    0    2]
[ 696 1962    0    0    0    0   -2    0]
[3340  770    2    0    0    0   -2   -2]
[700 122   0   2   0   0   0  -2]
[2112 3170    2   -2    0    0   -2   -2]
[4320 1586    2    0    0    0    0   -2]
[  88 2968    0    2    0    0   -2    0]
[3148  160    0    2    0    0   -4    2]
[3504 3170    0   -2    0    0    0    0]
[2512 3170    0    0    0    0   -2   -2]
[  90 3168    2   -2    0    0    2   -2]
[ 902 1150    0    0    0    0   -2    0]
[4112 2184    0    2    0    0   -2    2]
[ 696 1352    0    2    0    0   -2   -2]
[ 702 3366    2   -2    0    0   -2    0]
[3118 2376    0    0    0    0   -2   -2]
[1516 1766    4    2    0    0    0    0]
[4104 2578    0    0    0    0    0   -2]
[2726 1774    0    0    0    0   -2    0]
[2340  144    4   -2    0    0    2    0]
[2922 2176    2    0    0    0    0   -2]
[2322 1974    0    2    0    0   -2    2]
[ 490 1756   -2   -2    0    0   -2   -2]
[1104 2568    0   -2    0    0   -2   -2]
[902 946   2   2   0   0   0   4]
[3108 3170    0    0    0    0   -2   -2]
[2508 3370    0    0    0    0   -2    2]
[2124 1366    0    0    0    0   -2    2]
[1104 3368    0    0    0    0   -2   -2]
[2722 2174    0   -2    0    0    0    0]
[2728 1572    0    0    0    0   -2   -2]
[2114 2972    2    0    0    0    2    0]
[ 900 2570   -2    0    0    0   -2    0]
[698 326   0   0   0   0  -2  -2]
[4514 1590    2    2    0    0    0    0]
[2118 2374    2    0    0    0    0    2]
[3310 2974    0    0    0    0    0    0]
[2534  964    2    2    0    0    0    2]
[1920 1968    2   -2    0    0    0   -2]
[3706 2974    2    2    0    0    0    2]
[2908 3368    2    2    0    0    0    0]
[2330  960    0    0    0    0   -2    0]
[ 496 3168   -2    0    0    0   -4    0]
[2336  554    4    0    0    0    0    0]
[4494 2580    0    2    0    0    0    2]
[ 294 3168    2    2    0    0    0   -2]
[2316 2574    2    2    0    0   -2    0]
[ 900 1762   -2    2    0    0   -2    0]
[4496 2380   -2   -2    0    0   -2   -2]
[2740  560    2    2    0    0    2    2]
[2918 2576    2    2    0    0    0    2]
[  84 1956    0    0    0    0   -2   -2]
[1516 1564    2    2    0    0    2    0]
[3524 1980    4    0    0    0    2    2]
[ 490 1146   -2    2    0    0   -2    2]
[3124 1976    2   -2    0    0    0   -2]
[4124 1586    2    2    0    0    0    2]
[1724  544    2    0    0    0    0    0]
[494 324   0   0   0   0  -2  -2]
[3128 1576    0    0    0    0   -2    0]
[2948  154    2    0    0    0    2    0]
[  84 1550    2    0    0    0   -2   -2]
[ 82 730   2  -2   0   0   0   0]
[4290 2972    0    0    0    0   -2    2]
[2920 2374    2    0    0    0    0   -2]
[3324 1978    4    0    0    0    0    0]
[1518  950    0   -2    0    0    0   -2]
[4324 1188   -2    2    0    0   -4   -2]
[3696 3366    0    2    0    0   -2    2]
[4334  584   -2   -2    0    0   -2   -2]
[2516 2774    0    0    0    0   -2    0]
[4502 2184    0    0    0    0    0   -2]
[  86 1756    4    2    0    0    0    0]
[ 904 2770    4    0    0    0    2    0]
[  82 1140    0   -2    0    0   -2   -2]
